B 20 125 20	
1         35	 140	  35	 1500	 108	 173	 108
1500	 108	 173   	 108     1500    192     202     192
1500	 192	 202	 192	 1800	 255	 255	 224
1800	 255	 255	 224	 2100	 238	 238	 219
2100	 238	 238	 219	 2500	 238	 216	 174
2500	 238 	 216	 174	 3000	 205	 170	 125
3000	 205	 170	 125	 3500	 139	  90	  43
3500	 139	  90	  43	 4000	 216	 191	 216
4000	 216	 191	 216	 4500	 225	 225	 225
4500	 225	 225	 225	 5000	 255	 255	 255
5000	 255	 255	 255	 5500	 255	 255	 255
F	255	255	255
