B 20 125 20	
1       0	     100	 230	      500	   0	 100	 230
500	   0	 200   	 230     1000      0     230     100
1000	   0	 230	 100	 1500	  75	 250	  50
1500	  75	 250	  50	 2000	 150	 255	   0
2000	 150	 255	   0	 2500	 210	 255	   0
2500	 210 	 255	   0	 3000	 255	 255	   0
3000	 255	 255	   0	 3500	 255	 200	   0
3500	 255	 200	   0	 4000	 255	 150	   0
4000	 255	 150	   0	 4500	 230	 100	   0
4500	 230	 100	   0	 5000	 200	  50	   0
5000	 200	  50	   0	 5500	 150	   0	   0
5500     200      50       0     6000    150       0       0
F	255	255	255
